At what time does State Bank in Ranchi close on July 4th?	o o o o b-businessname i-businessname o b-localityname b-openhoursdescriptor o b-datetimeexpression i-datetimeexpression
What is the rating?	o o o o
Is Megastore open 24 hours on Tuesdays?	o b-businessname b-openhoursdescriptor i-openhoursdescriptor i-openhoursdescriptor o b-dayopen
I want to know the hours at Dmart	o o o o o b-openhoursdescriptor o b-businessname
Where is the best place to enjoy some Hindustani classical music in New Delhi?	o o o b-sortby o o o o o b-restaurantamenity i-restaurantamenity o b-localityname i-localityname
When does Nirula burger usually open?	o o b-businessname i-businessname o b-openhoursdescriptor
Locate some supermarkets around me that are open right now	o o b-businesscategory o o o o b-openhoursdescriptor o o
Is the Barbeque Nation closed at this time?	o b-businessname i-businessname i-businessname b-openhoursdescriptor o o o
When does the grocery items shop closes on Mondays?	o o o b-businesscategory i-businesscategory i-businesscategory b-openhoursdescriptor o b-dayopen
Do you know about any dharamshalas around here?	o o o o o b-businesscategory o o
Please find me some affordable restaurants in Banjara Hills	o o o o b-pricelevel b-restaurantstyle o b-localityname i-localityname
Find petrol pumps	o b-businesscategory i-businesscategory
Tell me the opening hours for Nirmal café	o o o b-openhoursdescriptor i-openhoursdescriptor o b-businessname i-businessname
Is the community centre closed now?	o o b-businesscategory i-businesscategory b-openhoursdescriptor o
Do tell me when does Mainland China closes tomorrow	o o o o o b-businessname i-businessname b-openhoursdescriptor b-datetimeexpression
Do you know if Lakme is open 24 hours on weekends?	o o o o b-businessname o b-openhoursdescriptor i-openhoursdescriptor i-openhoursdescriptor o b-intervalopen
Look for a data analyst in Bangalore	o o o b-businesscategory i-businesscategory o b-localityname
What is a good place to eat dosa?	o o o o b-restaurantstyle i-restaurantstyle i-restaurantstyle b-foodname
Opening hours for jewellery shop on weekdays	b-openhoursdescriptor i-openhoursdescriptor o b-businesscategory i-businesscategory b-datetimeexpression i-datetimeexpression
Look up for the supermarkets in Juhu beach	o o o o b-businesscategory o b-localityname i-localityname
Where can I find a phone repair shop nearby?	o o o o o b-businesscategory i-businesscategory i-businesscategory o
Locate a restaurant open now that serves veg?	o o b-restaurantstyle b-openhoursdescriptor o o o b-foodname
Where is the nearest homecentre?	o o o b-sortby b-businessname
Is bigbasket in Noida open on Sundays?	o b-businessname o b-localityname b-openhoursdescriptor o b-dayopen
Is café coffee day in andheri west open on Saturdays?	o b-businessname i-businessname i-businessname o b-localityname i-localityname b-openhoursdescriptor o o
Is New pizza hut open now	o b-businessname i-businessname i-businessname b-openhoursdescriptor o
Find a parlour open this week	o o b-businesscategory b-openhoursdescriptor b-datetimeexpression i-datetimeexpression
I need suggestions for refrigerator repair services	o o o o b-businesscategory i-businesscategory i-businesscategory
Nearest 24 hour cult fitness centre	b-sortby b-businessname i-businessname i-businessname i-businessname i-businessname
Search for animal hospitals in Rajouri garden	o o b-businesscategory i-businesscategory o b-localityname i-localityname
What time does Kolkata Kathi Rolls open tomorrow	o o o b-businessname i-businessname i-businessname b-openhoursdescriptor b-datetimeexpression
Tell me when does spencer’s close tomorrow?	o o o o b-businessname b-openhoursdescriptor b-datetimeexpression
Are there any pure vegetarian restaurants near me that deliver	o o o o b-diet b-restaurantstyle o o o b-restaurantamenity
Find barista coffee shops open 24hrs next weekend	o b-restaurantstyle i-restaurantstyle i-restaurantstyle b-openhoursdescriptor i-openhoursdescriptor b-datetimeexpression i-datetimeexpression
What are the top Indian cuisine restaurants in Pitampura	o o o b-sortby b-restaurantstyle i-restaurantstyle i-restaurantstyle o b-localityname
Check if cult fitness centre is open at 6 am	o o b-businessname i-businessname i-businessname o b-openhoursdescriptor o b-datetimeexpression i-datetimeexpression
Search for Hindi libraries open on Sundays	o o b-businesscategory i-businesscategory b-openhoursdescriptor o b-dayopen
What are the hours for PVRs	o o o b-openhoursdescriptor o b-businessname
Is cafe coffee day in Juhu open on march 3rd?	o b-businessname i-businessname i-businessname o b-localityname b-openhoursdescriptor o b-datetimeexpression i-datetimeexpression
Check and tell me when they open	o o o o o o b-openhoursdescriptor
Find naturals ice cream in Hyderabad	o b-businessname i-businessname i-businessname o b-localityname
Look up fun things to do in Delhi	o o b-businesscategory i-businesscategory i-businesscategory i-businesscategory o b-localityname
Find affordable restaurants	o b-pricelevel b-restaurantstyle
Is there a place I can get my bike serviced?	o o o o o o o o b-service i-service
Check what time flurry's pastry shop opens on Thursday	o o o b-businessname i-businessname i-businessname b-openhoursdescriptor o b-datetimeexpression
What are the hours for the Karachi Bakery next month?	o o o b-openhoursdescriptor o b-businessname i-businessname i-businessname b-datetimeexpression i-datetimeexpression
When does the library in park street open after lunch?	o o o b-businesscategory o b-localityname i-localityname b-openhoursdescriptor b-datetimeexpression i-datetimeexpression
Search for restaurants in the 400 rupees and 500 rupees range	o o b-restaurantstyle o o b-pricelevel i-pricelevel o i-pricelevel i-pricelevel o
What restaurants are open near my current location	o b-restaurantstyle o b-openhoursdescriptor o o o o
What should I have for the evening today?	o o o o o o b-datetimeexpression i-datetimeexpression
What are some good pubs?	o o o o b-businesscategory
Look for best rated refrigerator services	o o b-sortby o b-businesscategory i-businesscategory
Is max closed?	o b-businessname b-openhoursdescriptor
Tell me the rating	o o o o
When does oven story pizza in lajpat nagar close?	o o b-businessname i-businessname i-businessname o b-localityname i-localityname b-openhoursdescriptor
Please check if there are any banks open at 4 pm around me	o o o o o o b-businesscategory b-openhoursdescriptor o b-datetimeexpression i-datetimeexpression o o
What time does Decathlon close?	o o o b-businessname b-openhoursdescriptor
Dmart weekend opening times​	b-businessname b-intervalopen b-openhoursdescriptor o
What time does Chai Point close?	o o o b-businessname i-businessname b-openhoursdescriptor
Is Questmall open	o b-businessname b-openhoursdescriptor
What's the nearest grocery	o o b-sortby b-businesscategory
Locate banks that are open on weekends	o b-businesscategory o o b-openhoursdescriptor o b-intervalopen
Is the Lalbagh botanical garden open today	o o b-businessname i-businessname i-businessname b-openhoursdescriptor b-datetimeexpression
Show me top dhabas nearby	o o b-sortby b-restaurantstyle o
What are the weekend hours for the Airtel?	o o o b-datetimeexpression b-openhoursdescriptor o o b-businessname
What are the top 10 Punjabi restaurants in Vasant Vihar	o o o b-sortby o b-restaurantstyle i-restaurantstyle o b-localityname i-localityname
Find me some cafes that are open now	o o o b-restaurantstyle o o b-openhoursdescriptor o
Is Mehake Punjab in Gurgaon open today?	o b-businessname i-businessname o b-localityname b-openhoursdescriptor b-datetimeexpression
At what time does Zara in Lonavala open?	o o o o b-businessname o b-localityname b-openhoursdescriptor
Look for departmental store open 24hrs on July 4th	o o b-businesscategory i-businesscategory b-openhoursdescriptor i-openhoursdescriptor o b-datetimeexpression i-datetimeexpression
Where can I get a good haircut in Lajpat Nagar?	o o o o o o b-service o b-localityname i-localityname
Is Hattkappi open 24hrs next weekend?	o b-businessname b-openhoursdescriptor i-openhoursdescriptor b-datetimeexpression i-datetimeexpression
Is Superdry in WhiteField open?	o b-businessname o b-localityname b-openhoursdescriptor
Is the Trinka's restaurant open at 7pm	o o b-businessname b-restaurantstyle b-openhoursdescriptor o b-datetimeexpression
Find a Bengali restaurant that isn't closed	o o b-cuisinestyle b-restaurantstyle o b-openhoursdescriptor i-openhoursdescriptor
Are they closed now?	o o b-openhoursdescriptor o
When does the Japanese Consulate close in Delhi?	o o o b-businesscategory i-businesscategory b-openhoursdescriptor o b-localityname
What are the hours for Cult Fitness centre	o o o b-openhoursdescriptor o b-businessname i-businessname i-businessname
Look up a Delhivery office near me	o o o b-businessname i-businessname o o
What time does the Municipality close?	o o o o b-businesscategory b-openhoursdescriptor
Check if the Banquet is open	o o o b-businesscategory o b-openhoursdescriptor
What vet clinics are still open now	o b-businesscategory i-businesscategory o o b-openhoursdescriptor o
Find haircut saloons	o b-businesscategory i-businesscategory
Is Max Mart open until 10 pm?	o b-businessname i-businessname b-openhoursdescriptor o b-datetimeexpression i-datetimeexpression
Look for a Gujrati cuisine eatery in Patiala open next month	o o o b-cuisinestyle b-restaurantstyle o o b-localityname b-openhoursdescriptor b-datetimeexpression i-datetimeexpression
Find the restaurant named Tamara 16 in new town, Kolkata	o o b-restaurantstyle o b-businessname i-businessname o b-localityname i-localityname i-localityname
When does the bakery close today?	o o o b-businesscategory b-openhoursdescriptor b-datetimeexpression
Get Kulfi stalls near me	o b-coursename o o o
Tell me where I can find good Mughlai food in nehru place	o o o o o o o b-cuisinestyle o o b-localityname i-localityname
Find a petrol pump open until midnight	o o b-businesscategory i-businesscategory b-openhoursdescriptor o b-datetimeexpression
Is there a DHL office open now?	o o o b-businessname i-businessname b-openhoursdescriptor o
Any Indian restaurants in the area?	o b-cuisinestyle b-restaurantstyle o o o
Bengali restaurants near me	b-cuisinestyle b-restaurantstyle o o
Tell me where i can find a domino’s pizza outlet	o o o o o o o b-businesscategory i-businesscategory i-businesscategory
When does decathlon close?	o o b-businessname b-openhoursdescriptor
Yelp ₹200 indian restaurants	o b-pricelevel b-cuisinestyle b-restaurantstyle
Is the national library open	o o b-businessname i-businessname b-openhoursdescriptor
Search for Air Cooler repair shops	o o b-businesscategory i-businesscategory i-businesscategory i-businesscategory
At what time does Vishal close?	o o o o b-businessname b-openhoursdescriptor
Search for banks that are open during weekends	o o b-businesscategory o o b-openhoursdescriptor o b-intervalopen
What are the 5 best rated dentists near me	o o o o b-sortby o b-businesscategory o o
Find Mainland China on yelp	o b-businessname i-businessname o o
Tell me where the closest public park is	o o o o b-sortby b-businesscategory i-businesscategory o
Is Nykaa open	o b-businessname b-openhoursdescriptor
Tell me a place where I can get tandoori	o o o o o o o o b-foodname
When does the drycleaners open?	o o o b-businesscategory b-openhoursdescriptor
Find me somewhere to get my Maruti repaired	o o o o o o b-service i-service
Find an Indian restaurant with outdoor seating in Worli Mumbai	o o b-cuisinestyle b-restaurantstyle o b-restaurantamenity i-restaurantamenity o b-neighborhoodname b-localityname
What are the hours of operation of Hard Rock	o o o b-openhoursdescriptor o o o b-businessname i-businessname
Find Hattkappi	o b-businessname
Look up a restaurant serving lamb mutton that is moderately priced	o o o b-restaurantstyle o b-foodname i-foodname o o b-pricelevel i-pricelevel
Is Ikea in Hyderabad open right now?	o b-businessname o b-localityname b-openhoursdescriptor o o
Search for restaurants with classical music	o o b-restaurantstyle o b-restaurantamenity i-restaurantamenity
Find pantaloons	o b-businessname
Is the Rakhi Gifts shop closed now?	o o b-businessname i-businessname i-businessname b-openhoursdescriptor o
Where are some good spots to eat Punjabi food	o o o o b-restaurantstyle i-restaurantstyle i-restaurantstyle b-cuisinestyle o
What time does Madhu shala open in Vijay Nagar	o o o b-businessname i-businessname b-openhoursdescriptor o b-localityname i-localityname
Find a romantic coffee shop in Raichur	o o b-restaurantquality b-cuisinestyle b-restaurantstyle o b-localityname
Find ₹200 restaurants open now	o b-pricelevel b-restaurantstyle b-openhoursdescriptor o
Look for an open milkshake shop	o o o b-openhoursdescriptor b-restaurantstyle i-restaurantstyle
Find a banquet hall that will be open on march 3rd	o o b-businesscategory i-businesscategory o o o b-openhoursdescriptor o b-datetimeexpression i-datetimeexpression
Where can I buy kalmi kebabs around here	o o o o b-foodname i-foodname o o
Find me somewhere to get my eyebrows plucked	o o o o o o b-service i-service
Locate a 24 hour fuel station	o o b-openhoursdescriptor i-openhoursdescriptor b-businesscategory i-businesscategory
Is Ovenstory open	o b-businessname b-openhoursdescriptor
Where is the closest reliancemart?	o o o b-sortby b-businessname
Is it closed yet?	o o b-openhoursdescriptor o
Look for a petrol station that is open 24/7	o o o b-businesscategory i-businesscategory o o b-openhoursdescriptor i-openhoursdescriptor
Is bambino cleaners open	o b-businessname i-businessname b-openhoursdescriptor
Look up when Grofers food closes tonight	o o o b-businessname i-businessname b-openhoursdescriptor b-datetimeexpression
Find a car sale near me	o o b-businessname i-businessname o o
Yelp rating for this one?	o o o o o
Which supermarkets are open right now	o b-businesscategory o b-openhoursdescriptor o o
Is Chulha Chawki da Dhaba open?	o b-businessname i-businessname i-businessname i-businessname b-openhoursdescriptor
Yelp for bakeries that deliver	o o b-restaurantstyle o b-restaurantamenity
Is the foodcourt in Phoenix Mall closed before 6 am	o o b-businessname o b-localityname i-localityname b-openhoursdescriptor b-datetimeexpression i-datetimeexpression i-datetimeexpression
Is the library in GK open after lunch?	o o b-businesscategory o b-localityname b-openhoursdescriptor b-datetimeexpression i-datetimeexpression
Get me the reviews for Mainland China	o o o o o b-businessname i-businessname
Look for O2 Spa in Gachhibowli	o o b-businessname i-businessname o b-localityname
Where should I go for lunch around here	o o o o o b-mealname o o
Find the nearest Zara stre	o o b-sortby b-businessname i-businessname
When does it open	o o o b-openhoursdescriptor
Is there a India post office that's not closed yet?	o o o b-businesscategory i-businesscategory i-businesscategory o b-openhoursdescriptor i-openhoursdescriptor o
Regular business hours for Pizza Hut	o b-openhoursdescriptor i-openhoursdescriptor o b-businessname i-businessname
Where's a good spot to drink?	o o o o o o
Is Raju Auto closed on weekends?	o b-businessname i-businessname b-openhoursdescriptor o b-intervalopen
Find the highest rated ₹300 restaurant open now	o o b-sortby i-sortby b-pricelevel b-restaurantstyle b-openhoursdescriptor o
Locate me some restaurants for a birthday celebration	o o o b-restaurantstyle o o b-restaurantquality i-restaurantquality
What are Pantaloons store's hours?	o o b-businessname i-businessname b-openhoursdescriptor
Is Chai time bar open now?	o b-businessname i-businessname i-businessname b-openhoursdescriptor o
See if CCD is open on Tuesdays	o o b-businessname o b-openhoursdescriptor o b-dayopen
What are the hours of operation for the National Public Library	o o o b-openhoursdescriptor o o o o b-businessname i-businessname i-businessname
Where can I get my tattoo done?	o o o o o b-service i-service
How many stars for this place?	o o o o o o
Where can I get my eyebrows threaded?	o o o o o b-service i-service
Is Prathibha badminton open on weekdays?	o b-businessname i-businessname b-openhoursdescriptor o b-intervalopen
Where is the nearest reliance Jio Mart that's open now?	o o o b-sortby b-businessname i-businessname i-businessname o b-openhoursdescriptor o
Find a pet store in Meerut open after 5 pm	o o b-businesscategory i-businesscategory o b-localityname b-openhoursdescriptor b-datetimeexpression i-datetimeexpression i-datetimeexpression
Can you tell me if Reliance Trends is open right now?	o o o o o b-businessname i-businessname o b-openhoursdescriptor b-datetimeexpression i-datetimeexpression
Opening hours for Decathelon on Saturdays	b-openhoursdescriptor i-openhoursdescriptor o b-businessname o b-dayopen
What is the rating for Commercial Street?	o o o o o b-businessname i-businessname
Is Soda Bottle open on Sundays	o b-businessname i-businessname b-openhoursdescriptor o b-dayopen
Find a grocery store open 24 hrs	o o b-businesscategory i-businesscategory b-openhoursdescriptor i-openhoursdescriptor i-openhoursdescriptor
Find a supermarket open after lunch	o o b-businesscategory b-openhoursdescriptor b-datetimeexpression i-datetimeexpression
What are the bakery's hours today?	o o o b-businesscategory b-openhoursdescriptor b-datetimeexpression
Find a Bluedart office near me	o o b-businessname i-businessname o o
Where's the nearest Jio Mart	o o b-sortby b-businessname i-businessname
What are the hours at Chilli	o o o b-openhoursdescriptor o b-businessname
Is the bowling alley in Phoenix closed on weekdays	o o b-businesscategory i-businesscategory o b-localityname b-openhoursdescriptor o b-intervalopen
Only show the ones that are open now	o o o o o o b-openhoursdescriptor o
When does More Megastore open?	o o b-businessname i-businessname b-openhoursdescriptor
Do you think Homecentre remains open until 10 pm?	o o o b-businessname o b-openhoursdescriptor o b-datetimeexpression i-datetimeexpression
What are the most expensive vegetarian restaurants in Delhi	o o o b-pricelevel i-pricelevel b-restaurantstyle i-restaurantstyle o b-localityname
Look up restaurants that have happy hour	o o b-restaurantstyle o o b-restaurantamenity i-restaurantamenity
When does the Berry Cake Cafe open?	o o o b-businessname i-businessname i-businessname b-openhoursdescriptor
Look for air conditioning repair on yelp	o o b-businesscategory i-businesscategory i-businesscategory o o
Look for discos open today	o o b-restaurantstyle b-openhoursdescriptor b-datetimeexpression
Find Jain restaurants	o b-cuisinestyle b-restaurantstyle
What's the nearest wine shop	o o b-sortby b-restaurantstyle i-restaurantstyle
What's the usual Reliance Fresh Mart opening time?	o o o b-businessname i-businessname i-businessname b-openhoursdescriptor o
Tell me the opening hours for Big Brewsky tomorrow	o o o b-openhoursdescriptor i-openhoursdescriptor o b-businessname i-businessname b-datetimeexpression
What are the ratings for Lord of the Drinks in New Delhi?	o o o o o b-businessname i-businessname i-businessname i-businessname o b-localityname i-localityname
Just show the restaurants that are open Sunday at 2 am	o o o b-restaurantstyle o o b-openhoursdescriptor b-datetimeexpression i-datetimeexpression i-datetimeexpression i-datetimeexpression
What is the opening time for the bank?	o o o b-openhoursdescriptor o o o b-businesscategory
Is Hometown open for 24 hours?	o b-businessname b-openhoursdescriptor i-openhoursdescriptor i-openhoursdescriptor i-openhoursdescriptor
Is Dmart open 24 hours?	o b-businessname b-openhoursdescriptor i-openhoursdescriptor i-openhoursdescriptor
Search for bakeries open at 6 am	o o b-restaurantstyle b-openhoursdescriptor o b-datetimeexpression i-datetimeexpression
When does Nykaa close?	o o b-businessname b-openhoursdescriptor
Where is the cheapest parking in Kormangala	o o o b-pricelevel b-businesscategory o b-searchterm
Find auto shops that are open on weekdays	o b-businesscategory i-businesscategory o o b-openhoursdescriptor o b-intervalopen
Find a cheap winehouse nearby	o o b-pricelevel b-restaurantstyle o
What are the Banaghatta Road zoo hours of operation​	o o o b-businessname i-businessname i-businessname b-openhoursdescriptor i-openhoursdescriptor i-openhoursdescriptor
Find Nizam's restaurant near Char Minar	o b-businessname b-restaurantstyle o b-localityname i-localityname
Is Trinka’s factory open on Mondays?	o b-businessname i-businessname b-openhoursdescriptor o b-dayopen
Locate a Spencer’s that's open until 11 pm	o o b-businessname o b-openhoursdescriptor o b-datetimeexpression i-datetimeexpression
What's a nice restaurant open Friday at 7 pm in Rajouri?	o o o b-restaurantstyle b-openhoursdescriptor b-datetimeexpression i-datetimeexpression i-datetimeexpression i-datetimeexpression o b-localityname
Check what time they close	o o o o b-openhoursdescriptor
Look up laptop repair shops on yelp	o o b-businesscategory i-businesscategory i-businesscategory o o
Show the ones that are open at 8 am	o o o o o b-openhoursdescriptor o b-datetimeexpression i-datetimeexpression
Is Lazeez in new town open right now?	o b-businessname o b-localityname i-localityname b-openhoursdescriptor o o
When does the postoffice of India close?	o o o b-businesscategory i-businesscategory i-businesscategory b-openhoursdescriptor
Look up Hoppi Polla on yelp	o o b-businessname i-businessname o o
Find PVR multiplexes near me	o b-businessname i-businessname o o
Look for blood and plasma donation banks	o o b-businesscategory i-businesscategory i-businesscategory i-businesscategory i-businesscategory
Find Itsybitsy outlets nearby	o b-businesscategory i-businesscategory o
Search yelp for the most expensive hair salons in Mumbai	o o o o b-pricelevel i-pricelevel b-businesscategory i-businesscategory o b-localityname
Is Home town closed tomorrow?	o b-businessname i-businessname b-openhoursdescriptor b-datetimeexpression
When does the Inox cinemas open	o o o b-businessname i-businessname b-openhoursdescriptor
I need a good bakery	o o o o b-restaurantstyle
When does Barbeque Nation close on Mondays?	o o b-businessname i-businessname b-openhoursdescriptor o b-dayopen
Check yelp for a Cafe Coffee Day near me	o o o o b-businesscategory i-businesscategory i-businesscategory o o
Search for coffee shops with Wi-Fi that are open Tuesday at 7	o o b-restaurantstyle i-restaurantstyle o b-businessamenity o o b-openhoursdescriptor b-datetimeexpression i-datetimeexpression i-datetimeexpression
Look up Gujrati restaurants open tomorrow at 8pm	o o b-cuisinestyle b-restaurantstyle b-openhoursdescriptor b-datetimeexpression i-datetimeexpression i-datetimeexpression
Is the Blue Nile open on weekdays?	o b-businessname i-businessname i-businessname b-openhoursdescriptor o b-intervalopen
When does cult fitness centre in Bangalore open on Mondays?	o o b-businessname i-businessname i-businessname o b-localityname b-openhoursdescriptor o b-dayopen
Help me find a veg restaurant in yelp	o o o o b-diet b-restaurantstyle o o
Ask yelp for a Lassi shop	o o o o b-businesscategory o
Is Tamasha Cafe open	o b-businessname i-businessname b-openhoursdescriptor
Find Aminia restaurant in Kolkata	o b-businessname b-restaurantstyle o b-localityname
Find refrigerator shop on yelp	o b-businesscategory i-businesscategory o o
Is the doll museum in New Delhi open	o o b-businessname i-businessname o b-localityname i-localityname b-openhoursdescriptor
Is the Apsara Icecreams open?	o b-businessname i-businessname i-businessname b-openhoursdescriptor
What are some tourist attractions near Agra?	o o o b-businesscategory i-businesscategory o b-localityname
What are the hours for the Therpuppy shop tonight?	o o o b-openhoursdescriptor o o b-businesscategory i-businesscategory b-datetimeexpression
Do any of these deliver	o o o o b-restaurantamenity
Find a doctor that's open on Wednesday	o o b-businesscategory o b-openhoursdescriptor o b-datetimeexpression
Find highly rated coffee shops in Mumbai	o b-sortby i-sortby b-restaurantstyle i-restaurantstyle o b-localityname
What are the hours for Max?	o o o b-openhoursdescriptor o b-businessname
Is the Five Star Chicken in Marathahalli closed tomorrow at noon?	o o b-businessname i-businessname o o b-localityname b-openhoursdescriptor b-datetimeexpression i-datetimeexpression i-datetimeexpression
When does the Ikea in mumbai open	o o o b-businessname o b-localityname b-openhoursdescriptor
Does Beer Cafe close late?	o b-businessname i-businessname b-openhoursdescriptor o
Find a library that's open at 8 pm on Saturday	o o b-businesscategory o b-openhoursdescriptor o b-datetimeexpression i-datetimeexpression i-datetimeexpression i-datetimeexpression
On Wednesdays, is the Nile open?	o b-dayopen o o b-businessname b-openhoursdescriptor
Recommended spots to eat parathas	o b-restaurantstyle o o b-cuisinestyle
Find restaurants with classical music	o b-restaurantstyle o b-restaurantamenity i-restaurantamenity
At what time does Dmart on MG Road open on march 3rd?	o o o o b-businessname o b-localityname i-localityname b-openhoursdescriptor o b-datetimeexpression i-datetimeexpression
Find a restaurant called Karim’s Biryani that's in Jama Masjid, New Delhi	o o b-restaurantstyle o b-businessname i-businessname o o b-localityname i-localityname i-localityname i-localityname
Look up wifi enabled cafes	o o b-businessamenity i-businessamenity b-restaurantstyle
What time does Jiomart close today?	o o o b-businessname b-openhoursdescriptor b-datetimeexpression
Check if Subway is open before 5 am	o o b-businessname o b-openhoursdescriptor b-datetimeexpression i-datetimeexpression i-datetimeexpression
Check opening hours for Cult Fitness centre this weekend	o b-openhoursdescriptor i-openhoursdescriptor o b-businessname i-businessname i-businessname b-datetimeexpression i-datetimeexpression
Tell me Mughlai biryani places	o o b-cuisinestyle b-restaurantstyle i-restaurantstyle
Yelp ₹100 dosa stalls	o b-pricelevel b-cuisinestyle b-restaurantstyle
Give me the ratings for Bowl o'China restaurant in Gachhi Bowli	o o o o o b-businessname i-businessname b-restaurantstyle o b-localityname i-localityname
When do they open	o o o b-openhoursdescriptor
Search for pet clinics near Domlur	o o b-businesscategory i-businesscategory o b-localityname
Find top bars in Navi Mumbai	o b-sortby b-restaurantstyle o b-localityname i-localityname
Are there mountains nearby	o o b-businesscategory o
Where can I drink tulsi tea	o o o o b-foodname i-foodname
Where are some recommended spots to eat in Bridage Road	o o o o b-restaurantstyle i-restaurantstyle i-restaurantstyle o b-localityname i-localityname
Look for ₹100 and ₹200 yelp restaurants	o o b-pricelevel o b-pricelevel o b-restaurantstyle
Find me restaurants serving veg food	o o b-restaurantstyle o b-cuisinestyle o
Is the Burger Centre in Juhu open Monday morning?	o o b-businessname i-businessname o b-localityname b-openhoursdescriptor b-datetimeexpression i-datetimeexpression
Is Pantaloons open until 9 pm?	o b-businessname b-openhoursdescriptor o b-datetimeexpression i-datetimeexpression
Where can I find an H&M store near me	o o o o o b-businessname o o o
Find a veg restaurant open right now	o o b-cuisinestyle b-restaurantstyle b-openhoursdescriptor o o
Are there bike shops nearby?	o o b-businesscategory i-businesscategory o
Is Decathlon closed	o b-businessname b-openhoursdescriptor
More megastore hours	b-businessname i-businessname b-openhoursdescriptor
Is Desi Platter in New Delhi closed on weekends	o b-businessname i-businessname o b-localityname i-localityname b-openhoursdescriptor o b-intervalopen
Are there any Subways within 2 kms of here?	o o o b-businessname o b-distancemagnitude b-distanceunit o o
Is the CCD open	o o b-businesscategory b-openhoursdescriptor
What's the rating for Ikea in Hyderabad?	o o o o b-businessname o b-localityname
Where is Sun city?	o o b-businessname i-businessname
What's the rating?	o o o
What time is Subway in Mayur Vihar open until?	o o o b-businessname o b-localityname i-localityname b-openhoursdescriptor o
Are there any vegetarian places near us that deliver	o o o b-diet o o o o b-restaurantamenity
Is Kebab Magic in Vasant Kunj closed right now?	o b-businessname i-businessname o b-localityname i-localityname b-openhoursdescriptor o o
Is there anything fun to do around South Goa?	o o b-businesscategory i-businesscategory i-businesscategory i-businesscategory o b-localityname i-localityname
Is Batista cafe closed	o b-businessname i-businessname b-openhoursdescriptor
Share reviews for Lifestyle in Acropolis Mall	o o o b-businessname o b-localityname i-localityname
How many reviews are there?	o o o o o
Can you tell me if HDFC bank in Halasuru closed on April 16th?	o o o o o b-businessname i-businessname o b-localityname b-openhoursdescriptor o b-datetimeexpression i-datetimeexpression
What is the rating?	o o o o
What is the rating of Paradise Biryani restaurant in Jubilee Hills?	o o o o o b-businessname i-businessname b-restaurantstyle o b-localityname i-localityname
Please let me know if the bank is closed	o o o o o o b-businesscategory o b-openhoursdescriptor
Is the petrol pump open for 24 hours on weekends?	o o b-businesscategory i-businesscategory b-openhoursdescriptor i-openhoursdescriptor i-openhoursdescriptor i-openhoursdescriptor o b-intervalopen
Does the bank get closed at 8 pm?	o o b-businesscategory o b-openhoursdescriptor o b-datetimeexpression i-datetimeexpression
Please find me a petrol pump that is open for 24 hours on Mondays	o o o o b-businesscategory i-businesscategory o o b-openhoursdescriptor i-openhoursdescriptor i-openhoursdescriptor i-openhoursdescriptor o b-dayopen
Please tell me if Reliance is open now	o o o o b-businessname o b-openhoursdescriptor o
What is the yelp rating for Nalli	o o o o o o b-businessname
Is the Citi Bank in Mehrouli open on June 3rd?	o o b-businessname i-businessname o b-localityname b-openhoursdescriptor o b-datetimeexpression i-datetimeexpression
What is the yelp rating for Indigo Blue?	o o o o o o b-businessname i-businessname
Do you think Grofers have closed by now?	o o o b-businessname o b-openhoursdescriptor o o
What is the yelp rating for Wanderla?	o o o o o o b-businessname
How many reviews does this place have?	o o o o o o o
What are Bank of Baroda's Saturday hours?	o o b-businessname i-businessname i-businessname b-datetimeexpression b-openhoursdescriptor
When does Canara bank in Jubilee open on March 27th?	o o b-businessname i-businessname o b-localityname b-openhoursdescriptor o b-datetimeexpression i-datetimeexpression
What are the reviews for this place?	o o o o o o o
What are the yelp ratings for this one?	o o o o o o o o
What's the yelp rating for Ikea in Mumbai?	o o o o o o b-localityname b-businessname
What are the hours for HSBC Bank in Kolkata on August 16th?	o o o b-openhoursdescriptor o b-businessname i-businessname o b-localityname o b-date i-date
Look for universities that are open on March 27th	o o b-businesscategory o o b-openhoursdescriptor o b-datetimeexpression i-datetimeexpression
What is the yelp rating for Smile dental in Banjara?	o o o o o o b-businessname i-businessname o b-localityname
Give me reviews for Palika Bazaar	o o o o b-businessname i-businessname
How many yelp stars does this place have?	o o o o o o o o
At what time does Freshfarm open in the morning?	o o o o b-businessname b-openhoursdescriptor b-datetimeexpression i-datetimeexpression i-datetimeexpression
What is the food rating for MMB Chicken?	o o o o o o b-businessname i-businessname
What time does Spencer’s close?	o o o b-businessname b-openhoursdescriptor
Find open salons	o b-openhoursdescriptor b-businesscategory
Is Arambagh open for 24 hours today?	o b-businessname b-openhoursdescriptor i-openhoursdescriptor i-openhoursdescriptor i-openhoursdescriptor b-datetimeexpression
